survey -> n 调查
standard -> n 标准；水平
row -> n 一排；一列；一行
in a row -> # 连续几次地
keyboard -> n 键盘式电子乐器；键盘
method -> n 方法；措施
instruction -> n 指示；命令
double -> v 加倍；是……的两倍  adj 两倍的；加倍的
shall -> modal v. 将要；将会
look back at -> # 回首（往事）；回忆；回顾
overcome / overcame / overcome -> v / pt / pp 克服；战胜
make a mess -> # 弄得一团糟（一塌糊涂）
graduate -> v 毕业；获得学位
keep one's cool -> # 沉住气；保持冷静
caring -> adj 体贴人的；关心他人的
ours -> pron 我们的
senior -> adj 级别（或地位）高的
senior high (school) -> # 高中
text -> n 课文；文本
go by -> # （时间）逝去；过去
level -> n 水平
degree -> n （大学）学位；度数；程度
manager -> n 经理；经营者
believe in -> # 信任；信赖
gentleman -> n 先生；绅士
graduation -> n 毕业
ceremony -> n 典礼；仪式
first of all -> # 首先
congratulate -> v 祝贺
thirsty -> adj 渴望的；口渴的
be thirsty for -> # 渴望；渴求
thankful -> adj 感谢；感激
be thankful to sb. -> # 对某人心存感激
lastly -> adv 最后
task -> n 任务；工作
ahead -> adv 向前面；在前面
ahead of -> # 在……前面
along with -> # 连同；除……以外还
responsible -> adj 有责任心的
be responsible for -> # 对……有责任；负责任
separate -> adj 单独的；分离的  v 分开；分离
set out -> #  出发；启程
separate from -> # 分离；隔开
wing -> n 翅膀；翼
