license / licence -> n 证；证件
safety -> n 安全；安全性
smoke -> v 吸烟；冒烟  n 烟
part-time -> adj&adv 兼职（的）
pierce -> v 扎；刺破；穿透
earring -> n 耳环；耳饰
flash -> n 闪光灯；闪光 v 闪耀；闪光
tiny -> adj 极小的；微小的
cry -> v&n 哭；叫喊
field -> n 田野；场地
hug -> n&v 拥抱；搂抱
lift -> v 举起；抬高  n 电梯；搭便车
badly -> adv 严重地；差；非常
talk back -> # 回嘴；顶嘴
awful -> adj 很坏的；讨厌的
teen -> n （13至19岁之间的）青少年
regret -> v&n 感到遗憾；懊悔
poem -> n 诗；韵文
community -> n 社区；社团
keep ... away from -> # 避免接近；远离
chance -> n  机会
make one's own decision -> # 自己做决定
educate -> v 教育；教导
manage -> v 完成（困难的事）；应付（困难的局面）
society -> n 社会
get in the way of -> # 挡……的路；妨碍
support -> v&n 支持
enter -> v 进来；进去
choice -> n 选择；挑选
Picasso -> 毕加索（西班牙画家）
