rather -> adv 相当；相反
would rather / 'd rather -> # 宁愿
drive -> v 迫使
drive sb. crazy/mad -> # 使人发疯/发狂
the more ... the more ... -> # 越……越……；愈……愈……
lately -> adv 最近；不久前
be friends with sb. -> # 成为某人的朋友
leave out -> # 忽略；不提及；不包括
friendship -> n 友谊；友情
king -> n 国王；君主
power -> n 权力；力量
prime -> adj 首要的；基本的
minister -> n 大臣；部长
prime minister -> # 首相；大臣
banker -> n 银行家
fame -> n 名声；声誉
pale -> adj 苍白的；灰白的
queen -> n 王后；女王
call in -> # 召来；叫来
examine -> v （仔细地）检查；检验
nor -> conj&adv 也不
neither ... nor ... ->  既不……也不……
palace -> n 王宫；宫殿
wealth -> n 财富
to start with -> # 起初；开始时
grey -> adj （天空）阴沉的；昏暗的；灰色的
lemon -> n 柠檬
uncomfortable -> adj 使人不舒服的；令人不舒适的
weight -> n 重量；分量
shoulder -> n 肩膀；肩
goal -> n 球门；射门；目标
let ... down -> # 使失望
coach -> n 教练；私人教师
kick -> v 踢；踹
kick sb. off -> # 开除某人
be hard on sb. -> # 对某人苛刻；对某人要求严厉
besides -> adv 而且
teammate -> n 同队队员；队友
courage -> n 勇敢；勇气
rather than -> # 而不是
guy -> n （非正式）家伙  (pl.)伙计们
pull -> v 拉；拖
pull together -> # 齐心协力；通力合作
relief -> n 轻松；解脱
nod -> v 点头
agreement -> n （意见或看法）一致；同意
fault -> n 过失；缺点
disappoint -> v 使失望

