custom -> n 风俗；习俗
bow -> v&n 鞠躬
kiss -> v&n 亲吻；接吻
greet -> v 和……打招呼；迎接
relaxed -> adj 放松的；自在的
value -> v 重视；珍视  n 价值
drop by -> # 顺便访问；随便进入
capital -> n 首都；国都
after all -> # 毕竟；终归
noon -> n 正午；中午
mad -> adj 很生气的；疯的
get mad -> # 大动肝火；气愤
effort -> n 努力；尽力
make an effort -> # 作出努力
passport -> n 护照
clean ... off -> # 把……擦掉
chalk -> n 粉笔
blackboard -> n 黑板
northern -> adj 北方的；北部的
coast -> n 海岸；海滨
season -> n 季；季节
knock -> v 敲；击   n 敲击声；敲击
eastern -> adj 东方的；东部的
take off -> # 脱下（衣服）；（飞机等）起飞
worth -> adj 值得；有……价值（的）
manner -> n 方式；方法   (pl.)礼貌；礼仪
empty -> adj 空的；空洞的
basic -> adj 基本的；基础的
exchange -> n&v 交换
go out of one's way -> # 特地；格外努力
make ... feel at home -> # 使（某人）感到宾至如归
teenage -> adj 十几岁的；青少年的
granddaughter -> n （外）孙女
behave -> v 表现；举止
except -> prep 除……之外   conj 除了；只是
elbow -> n 肘；胳膊
gradually -> adv 逐步地；渐近地
get used to -> # 习惯于
suggestion -> n 建议
Brazil -> 巴西
Mexico -> 墨西哥
Cali -> 卡利（哥伦比亚城市）
Colombia -> 哥伦比亚
Lausanne -> 洛桑（瑞士城市）
Norway -> 挪威
