过去很幽默=used to be humorous 
习惯于保持沉默 =be used to keeping silent
有用的建议 =helpful suggestions/ advice 
时常；有时=from time to time 
取得好成绩=get good scores 
得分；进球 v(三种形式)=score |  scores/ scored/ scoring 
背景=background
采访一位亚洲明星v(三种形式)= interview an Asian pop star | interviews/ interviewed/ interviewing 
工作面试=a job interview(n.) 
应对/处理害羞v(三种形式)=deal with shyness | deal- dealt-dealt/ deals/ dealing   
敢于做某事v(三种形式) =dare to do sth. | dares/ dared/ daring 
在人群面前=in front of crowds
获得大量关注=get tons of attention
私人时间=private time 
警卫；看守(单复数) =guard/ guards 
保卫国家v(三种形式) =guard the country | guards/ guarded/ guarding 
要求某人做某事v(三种形式)= require sb. to do sth. | requires/ required/ requiring 
一所欧洲/非洲寄宿学校= a European/ an African boarding school 
欧洲人/非洲人(单复数) =European/ Europeans; African/ Africans 
英式英语 =British English 
对当众做演讲感到紧张=be nervous about giving a speech in public 
公共场合=public place(s) 
蚂蚁(单复数)=ant/ ants 
害怕昆虫 =be afraid/scared of insects 
很少考试失败=seldom fail in examinations 
失败做某事v(三种形式) = fail to do sth. | fails/ failed/ failing 
影响学业v(三种形式) =influence the schoolwork | influences/ influenced/ influencing 
对……有影响=have an influence on 
逃课=be absent from classes 
亲自=in person 
确切地知道= know exactly 
完全正确= exactly right 
正好9点=exactly nine o’clock 
为……感到骄傲/自豪=take pride in = be proud of 
总介绍=a general introduction 
将军(单复数) =general/ generals 
