口语/书面语= spoken /written English
会话 = make conversations
读课本= read textbooks
大声读= read aloud
病人= patient
对.....有耐心=be patient with 
发现v.(三种形式) = discover discovered discovered
.....的秘诀(词组)=the secret to.....
他们的表情= their expressions      
查阅= look up sth.
物理 = physics 
化学n.= chemistry  
记忆v./ n. =memorize    memory 
发音 n./ v.(三种形式)= pronunciation  pronounce  pronounced  pronounced 
犯语法错误= make mistakes in grammar
重复v.(三种形式)+ing = repeat  repeated repeated repeating
造句子 = make sentences 
创建adj./v. (三种形式) = creative   create    created  created
创造某方面的兴趣 = create an interest in...  
关注注意(词组)= pay attention to
把..和..联系起来=connect ...with ...
联系v.(三种形式) =connect   connected    connected
知识来源于质疑= knowledge comes from questioning
聪明地学习= learn wisely
增加v.(三种形式)=increase  increased increased
增加阅读速度= increase reading speed
以....的速度=at a ....speed
同伴=partner
做某事的能力= the ability to do    
天生具有...=be born with ...
发现学英语很难= find it difficult to learn English
做笔记=take notes
记笔记v.(三种形式)=note noted noted
头脑n.= brain
积极参加=take an active part in
复习v.(三种形式)= review   reviewed   reviewed
做灯笼=make lanterns
赏月=admire the moon
陌生人=stranger
亲戚=relative
增加五磅体重= put on 5 pounds
从...偷=steal...from
偷(v./过去式/过分/三单/ing)=steal,stole,be stolen, steals, stealing
撒谎(v./过去式/过分/三单/ing)=lie lied lied lies lying
躺(v./过去式/过分/三单/ing) =lie lay lain lies lying   
看到某人正躺在=see sb. lying
放，下蛋(v./过去式/过分/三单/ing=)lay laid laid lays laying
下蛋=lay eggs
摆放甜点/礼物= lay out desserts/presents
花园=garden
对某人恶作剧=play a trick on sb.
对待v.(三种形式)= treat   treated    treated
用某物招待某人=treat sb. with sth.
她死了= She died
她死了=She is dead  
她的死亡=her death
她快死了=She is dying.
圣诞节=Christmas
由……写的长篇小说=a novel written by sb.
做生意 | 出差= do business  | on business
被惩罚 = be punished     
警告v.(三种形式) = warn warned  warned
警告某人做/不做某事 = warn sb. (not)to do sth.
目前= at present
温暖 n. =warmth     
传播(v./过去式/过分)=spread spread  spread
射击(v./过去式/过分)= shoot  shot shot
绑，系,领带n./ v.(三种形式) =tie/tie  tied  tied
新闻传播的很快=The news spreads quickly
已经传播= have/has spread
杭州位于中国东部=Hangzhou lies in the east of China.
位于v.(三种形式)/ing = lie lay  lain lying 
建议买一些邮票/明信片v(三种形式) =suggest buying some stamps/postcards | suggests/ suggested/ suggesting 
提议/建议某人做某事 = suggest (that) sb. (should) do
在书店旁边= beside the bookstore 
抱歉，对不起；什么，请再说一遍=pardon me 
花园= garden
通常；正常情况下 =normally 
仓促/急忙做某事v(三种形式)= rush(v.) to do sth. |rushes/ rushed/ rushing 
匆忙地=in a rush (n.) 
避开高峰期=avoid the rush hour 
附近的一家意大利餐馆=an Italian restaurant nearby (adv.)
一个意大利人=an Italian 
讲意大利语=speak Italian 
在去洗手间的路上= on the way to the restroom/ washroom/ bathroom
给你的朋友寄一些明信片v(三种形式)=mail some postcards to your friend | mails/ mailed/ mailing 
邮件，信件(不可数)= mail
沿着……向东走= go east along 
中心图书馆= central library 
经过 =go past / pass / pass by 
一名工作人员 = a staff person 
葡萄(单复数)= grape/ grapes 
迷人的；极有吸引力的=fascinating
不昂贵的=inexpensive
一家不拥挤的商场= an uncrowded mall 
对于某人来说做某事是方便的= It’s convenient for sb. to do sth.  
在…的拐角处= in the corner of 
一个礼貌的职员= a polite clerk 
礼貌地/不礼貌地提出请求= make requests politely/ impolitely 
请求某人做某事(词组) v(三种形式)= request sb. to do sth. | requests/ requested/ requesting 
请求/要求某人做某事(句型)= request (that) sb. (should) do 
方向；方位（单复数）= direction/ directions 
一个直接的问题 | 副词：= a direct question |	directly
讲（某种语言）的人；发言者(单复数) = speaker/ speakers 
正确的；恰当的 | 副词：= correct |  correctly
取决于谁 = depend on whom (放在介词后面，宾格)
听上去礼貌/不礼貌 =sound polite/ impolite
住址；地址；通讯处=address/ addresses 
一个地下停车场=an underground parking lot 
坐地铁去某地= go to sw. by underground 
课程；学科(单复数)= course/ courses 
过去很幽默=used to be humorous 
习惯于保持沉默 =be used to keeping silent
有用的建议 =helpful suggestions/ advice 
时常；有时=from time to time 
取得好成绩=get good scores 
得分；进球 v(三种形式)=score |  scores/ scored/ scoring 
背景=background
采访一位亚洲明星v(三种形式)= interview an Asian pop star | interviews/ interviewed/ interviewing 
工作面试=a job interview(n.) 
应对/处理害羞v(三种形式)=deal with shyness | deal- dealt-dealt/ deals/ dealing   
敢于做某事v(三种形式) =dare to do sth. | dares/ dared/ daring 
在人群面前=in front of crowds
获得大量关注=get tons of attention
私人时间=private time 
警卫；看守(单复数) =guard/ guards 
保卫国家v(三种形式) =guard the country | guards/ guarded/ guarding 
要求某人做某事v(三种形式)= require sb. to do sth. | requires/ required/ requiring 
一所欧洲/非洲寄宿学校= a European/ an African boarding school 
欧洲人/非洲人(单复数) =European/ Europeans; African/ Africans 
英式英语 =British English 
对当众做演讲感到紧张=be nervous about giving a speech in public 
公共场合=public place(s) 
蚂蚁(单复数)=ant/ ants 
害怕昆虫 =be afraid/scared of insects 
很少考试失败=seldom fail in examinations 
失败做某事v(三种形式) = fail to do sth. | fails/ failed/ failing 
影响学业v(三种形式) =influence the schoolwork | influences/ influenced/ influencing 
对……有影响=have an influence on 
逃课=be absent from classes 
亲自=in person 
确切地知道= know exactly 
完全正确= exactly right 
正好9点=exactly nine o’clock 
为……感到骄傲/自豪=take pride in = be proud of 
总介绍=a general introduction 
将军(单复数) =general/ generals 
