风俗(复数)= customs
鞠躬 v/-ing/pt/pp = bow ～s ～ing ～ed ～ed     ～ to sb.
亲吻 v/-ing/pt/pp =kiss ～es ～ing ～ed ～ed     ～sb.
打招呼v/-ing/pt/pp = greet ～s  ～ing  ～ed ～ed     
以错误的方式打招呼 =～...in the wrong way
轻松的(指人) （比较级）（最高级）、（指物）（比较级）（最高级）=relaxed   more ～    the most ～; relaxing  more～  the most ～
重视珍惜v./-ing/pt/pp/价值n./adj  =value  ～s  valuing ～d  ～d  valuable
顺便访问 =drop by   
自由落下v.比如在街上丢了钱包 v/-ing/pt/pp=drop (自由落下v.比如在街上丢了钱包～my wallet) ～s  ～ping ～ped  ～ped  毕竟 终归 after all
在中午=at noon
生气的（比较级、最高级） =mad ～der  ～ddest ;  be ～at sb.
做出努力 =make an effort/make efforts
把...擦掉=clean  sth.off
黑板 =blackboard
北 =north/northern    
南 =south/southern     
东=east/eastern    
西 =west/western
在海岸=on the coast
敲门=knock at/on the door
脱下衣服，飞机起飞 三单/-ing/pt/pp=take off  ～s  taking  took taken
餐桌礼仪=table manners
空的（比较级、最高级）=   An empty room   emptier  emptiest
基础的 =basic knowledge/skills
交换,货币兑换v./n.  用A去换B=in exchange(即in return)/  ～ A for B
格外努力= go out of one’s way或try one’s best或spare no effort to do
孙女、外孙女=granddaughter
行为v./三单/-ing/pt/pp =behave  ～s behaving ～d ～d   
注意言行=mind your behavior and words
除了prep. =Except doing sth./～ me/him...
我除了中文不会其他语言=I can’t speak foreign languages except Chinese.(除此之外没有)
我除了中文还会英语= I can speak English besides Chinese.(除此之外还有)
肘=An elbow
逐渐习惯于 =gradually get used to doing
被用来=Be used to do 
曾经=used to do 
建议 =suggest doing/suggest sb. (should) do  suggestions （可数名词）   Advise sb. to do    advice(不可数名词)
应该做某事= be supposed to do    
被允许做=be allowed to do 
别人希望你做某事 =be excepted do     
介词，除了、动词，希望、名词，专家=except(介词，除了) expect（动词，希望）expert (名词，专家)
第一次 =for the first time
我一伸出手 他鞠躬了 =As soon as I held out my hands ,he bowed.
我所在的地方，我们对时间很放松。 =Where I am from ,we are pretty relaxed about time.
我们经常散步，尽可能多地见朋友=We often walk,seeing as many of our friends as we can.
制定计划做某事=make plans to do
不算大事 =no big deal
打包温暖的衣服=pack warm clothes
进去之前先敲门= knock before entering
注意你的举止=mind your manners
勇敢面对挑战=face challenges bravely
交换生项目=on exchange student programs
毫无缘由=there's no reason to be
一个和我同龄的.....  =  a ...about my age
正如你能想象的= as you can imagine
另一个例子是=another example is that...
做某事很轻松=be comfortable doing
对做某事感到很轻松=be excited about doing
出现=show up
不舒适的= uncomfortable uncomfortably
值得花时间学一个国家的习俗=it's worth spending time to learn about the customs (be worth doing)
