安全adj./ n./ adv.=   safe safety safely
禁止吸烟=no smoking
使…被做=get/have sth. done
耳环=earring
哭 过去式=cried
他是这个领域的专家=he is the expert in this field.
在战场=on the field
在农场=in the field 
拥抱 v. /过去式=  hug hugged
举起 v. /过去式 /过去分词 = lift lifted lifted
可怕的一天 =an awful day
后悔v. /过去式/ 现在分词=regret regretted regretting
后悔做某事=regret doing
社区（复数）=communities
keep away from =stay away from
决定v. / n. =decide decision 
教育v. /adj./ n. =educate educational  education
克服做某事=manage to do
社会n. /adj.= society  social
不要让手机阻碍你的学习= don't let mobile phone in the way of your schoolwork.
阻碍=get in the way of
支持n./ v./ adj. =support support supportive/supporting
进入v./ n.= enter entrance
选择n. /v. pp pt = choice choose (chose chosen)
应该被允许=should be allowed
不能被鼓励=can't be encouraged to do
必须被给机会= must be given chances
不应被要求= should not be asked to do
被看到（听到）做某事= be seen/heard to do
某人自己的= one's own sth. /  sth. of one's own
不同意=disagree
十六岁的人=sixteen-year-olds
担心某人某事=be worried about sb./sth. | worry about sb./sth.
不够严谨=not serious enough
对…认真=be serious about 
保护某人免遭=protect sb. from doing
一个整夜啼哭的小婴儿=a tiny baby crying all night
截止到十点=by ten 
职业adj./ n. =professional  profession
在我身边=by my side  
不反对 =have nothing against doing
继续做某事=continue to do  
成功v./ n. /adj.  =succeed success successful
练习做某事=practice doing   
只有那时……才（倒装句）=only then will …
