restroom -> n （美）洗手间；公共厕所
stamp -> n 邮票；印章
bookstore -> n 书店
beside -> prep 在……旁边；在……附近
postcard -> n 明信片
pardon -> v 原谅  interj 请再说一遍
washroom -> n 洗手间； 厕所
bathroom -> n 浴室；洗手间
normally -> adv 通常；正常情况下
rush -> v&n 仓促；急促
suggest -> v 建议；提议
pass by -> 路过；经过
staff -> n 管理人员；职工
grape -> n 葡萄
central -> adj 中心的；中央的
nearby -> adj 附近的；邻近的   adv 在附近；附近
pardon me -> 抱歉，对不起；什么，请再说一遍
mail -> v 邮寄；发电子邮件   n 邮件；信件
east -> adj 东方的；东部的   adv 向东；朝东   n 东；东方
fascinating -> adj 迷人的；极有吸引力的
inexpensive -> adj 不昂贵的
uncrowded -> adj 不拥挤的；人少的
convenient -> adj 便利的；方便的
mall -> n 商场；购物中心
clerk -> n 职员
corner -> n 拐角；角落
politely -> adv 礼貌地；客气地
request -> n&v 要求；请求
direction -> n 方向；方位
correct -> adj 正确的；恰当的
polite -> adj 有礼貌的；客气的
direct -> adj 直接的；直率的
speaker -> n 讲（某种语言）的人；发言者
whom -> pron 谁；什么人
impolite -> adj 不礼貌的；粗鲁的
address -> n 住址；地址；通讯处
underground -> adj 地下的 n 地铁
parking lot -> 停车场；停车区
course -> n 课程；学科
Italian -> adj 意大利（人）的   n 意大利人；意大利语
