heel -> n 鞋跟；足跟
scoop -> n 勺；铲子
electricity -> n 电；电能
style -> n 样式；款式
project -> n 项目；工程
pleasure -> n 高兴；愉快
zipper / zip -> n 拉链；拉锁
daily -> adj 每日的；日常的
have a point -> 有道理
website -> n 网站
pioneer -> n 先锋；先驱
list -> v 列表；列清单 n 名单；清单
mention -> v 提到；说到
accidental -> adj 意外的；偶然的
by accident -> 偶然；意外地
ruler -> n 统治者；支配者
boil -> v 煮沸；烧开
remain -> v 保持不变；剩余
smell / smelt smelled / smelt smelled -> n 气味  v / pt / pp 发出……气味；闻到
saint -> n 圣人；圣徒
national -> adj 国家的；民族的
trade -> n 贸易；交易  v 做买卖；从事贸易
take place -> 发生；出现
popularity ->  n 受欢迎；普及
doubt -> n 疑惑；疑问  v 怀疑
without doubt -> 毫无疑问；的确
fridge -> n 冰箱
low -> adj 低的；矮的
somebody -> pron 某人  n 重要人物
translate -> v 翻译
lock -> v 锁上；锁住  n 锁
ring /rang /rung -> v （使）发出钟声或铃声；打电话
earthquake -> n 地震
sudden -> adj 突然（的）
all of a sudden -> 突然；猛地
bell -> n 钟（声）；铃（声）
biscuit -> n 饼干
cookie -> n 曲奇饼
musical -> adj 音乐的；有音乐天赋的
instrument -> n 器械；仪器；工具
crispy -> adj 脆的；酥脆的
salty -> adj 咸的
sour -> adj 酸的；酸味的
by mistake -> 错误地；无意中
customer -> n 顾客；客户
the Olympics -> 奥林匹克运动会
Canadian -> adj 加拿大的；加拿大人的 n 加拿大人
divide -> v 分开；分散
divide ... into -> 把……分开
basket -> n 篮；筐
not only ... but also ... -> 不但……而且……
look up to -> 钦佩；仰慕
hero -> n 英雄；男主角
professional -> adj 职业的；专业的
nearly -> adv 几乎
Berlin -> 柏林
NBA (National Basketball Association) -> 国家篮球协会（美职篮）
CBA (China Basketball Association) -> 中国篮球协会
