mooncake -> n 月饼
lantern -> n  灯笼
stranger -> n 陌生人
relative -> n 亲属；亲戚
put on -> 增加（体重）；发胖
pound -> n 磅；英镑
folk -> adj 民间的；民俗的
goddess -> n 女神
whoever -> pron 无论谁；不管什么人
steal / stole / stolen -> v / pt / pp 偷；窃取
lay / laid / laid -> v / pt / pp 放置；安放；产（卵）；下（蛋）
lay out -> 摆开；布置
dessert -> n （饭后）甜点；甜食
garden -> n 花园；园子
tradition -> n 传统
admire -> v 欣赏；仰慕
tie -> n 领带  v 捆；束
haunted -> adj 有鬼魂出没的；闹鬼的
ghost -> n 鬼；鬼魂
trick -> n 花招；把戏
treat -> n 款待；招待 v 招待；请（客）
spider -> n 蜘蛛
Christmas -> n 圣诞节
lie / lay / lain -> v / pt / pp 存在；平躺；处于
novel -> n （长篇）小说
eve -> n 前夕；前夜
dead -> adj 死的；失去生命的
business -> n 生意；商业
punish -> v 处罚；惩罚
warn -> v 警告；告诫
end up -> 最终成为；最后处于
present -> n 现在；礼物  adj 现在的
warmth -> n 温暖；暖和
spread / spread / spread -> v / pt / pp 传播；展开 n 蔓延；传播
Macao -> 澳门
Chiang Mai -> 清迈（泰国城市）
Water Festival -> 泼水节
Mid-Autumn Festival -> 中秋节
Mother's Day -> 母亲节
Father's Day -> 父亲节
Halloween -> 万圣节前夕
A Christmas Carol -> 《圣诞欢歌》（小说名）
Easter -> 复活节
Clara -> 克拉拉
Santa Claus -> 圣诞老人
Charles Dickens -> 查尔斯×狄更斯
Scrooge -> 斯克鲁奇  n （非正式）吝啬鬼
Jacob Marley -> 雅各布×马利
