chopstick -> n 筷子
coin -> n 硬币
fork -> n 餐叉；叉子
blouse -> n （女式）短上衣；衬衫
silver -> n 银；银器  adj 银色的
glass -> n 玻璃
cotton -> n 棉；棉花
steel -> n 钢；钢铁
fair -> n 展览会；交易会
environmental -> adj 自然环境的；有关环境的
grass -> n 草；草地
leaf / leaves -> n / pl 叶；叶子
produce -> v 生产；制造；出产
widely -> adv 广泛地；普遍地
be known for -> 以……闻名；为人知晓
process -> v 加工；处理  n 过程
pack -> v 包装；装箱
product -> n 产品；制品
France -> 法国
no matter -> 不论；无论
local -> adj 当地的；本地的
brand -> n 品牌；牌子
avoid -> v 避免；回避
handbag -> n 小手提包
mobile -> adj 可移动的；非固定的
everyday -> adj 每天的；日常的
boss -> n 老板；上司
Germany -> 德国
surface -> n 表面；表层
material -> n 材料；原料
traffic -> n 交通；路上行驶的车辆
postman -> n 邮递员
cap -> n （尤指有帽舌的）帽子
glove -> n （分手指的）手套
international -> adj 国际的
competitor -> n 参赛者；竞争者
its -> adj 它的
form -> n 形式；类型
clay -> n 黏土；陶土
celebration -> n 庆典；庆祝活动
balloon -> n 气球
paper cutting -> 剪纸
scissors -> n (pl.) 剪刀
lively -> adj 生气勃勃的；（色彩）鲜艳的
fairy tale -> 童话故事
historical -> adj （有关）历史的
heat -> n 热；高温  v 加热；变热
polish -> v 磨光；修改；润色
complete -> v 完成
Korea -> 朝鲜；韩国
Switzerland -> 瑞士
San Francisco -> 圣弗朗西斯科 （旧金山）
