宁愿做某事(A)而不愿做某事(B)(两种)= would rather do (A) than do (B); / prefer to do(A) rather than do (B)
最近(两种)相当不舒服 = rather(adv.) uncomfortable lately/recently 
我越了解她越发现我们有许多共同之处= The more I get to know her, the more I have realized we have a lot in common.
使人发疯/发狂 v(三种形式) 形容词的比较级/最高级 =drive sb. crazy/ mad   |drive-drove-driven | crazier madder/ craziest maddest 
成为银行家/国王/首相的朋友 = be friends with the banker/ king/ prime minister
受到冷落= feel left out 
使友谊更坚固= make friendship stronger 
A和B之间的友谊 = the friendship between A and B
大不列颠的国王 =the king in Britain 
一位拥有很大权力的女王= a queen with great power(不可数)
大不列颠一位拥有很大权力的女王 = a queen with great power(不可数) in Britain 
和粉笔一样苍白 =as pale as chalk 
被召来做某事 =be called in to do sth. 
(仔细)检查(e开头)这些澳大利亚人(动词四种形式) = examine the Australians （examines/ examined/ examined/ examining）
被检查v(另外两种形式)= be examined | examines/ examining 
他和我都不是学生。=Neither he nor I am a student. 
宫殿(单复数)= palace/ palaces 
故宫 = the Palace Museum / the Purple Forbidden City
颐和园= the Summer Palace 
拥有很多财富/勇气/名声 =have plenty of wealth/courage/fame  
起初，开始 =to start with 
灰暗/阴沉的天空 =grey sky 
柠檬(单复数) =lemon(s)
肩上的重担=a heavy weight on one’s shoulders 
减肥/增肥= lose weight/ put on weight 
错过进球=miss scoring the goal 
实现目标 = achieve the goal(s)
使某人失望(两种) v(三种形式+过分) = let…down / disappoint sb. |disappoints/ disappointed/ disappointing+ disappointed   lets/ let/ letting +let 
感到失望 =feel disappointed 
令人失望的新闻 =disappointing news
教练；私人教师(单复数)= coach(es) 
开除某人v(三种形式)= kick sb. off | kicks/ kicking/ kicked
对某人苛刻/要求严厉(两种)= be hard on sb. / be strict with sb. 
而且；除……之外，还（包括）做加法= besides 
除……之外（不包括）做减法= except 
继续齐心协力/努力合作 =continue to pull together 
快要把某物拖/拉出来了v(另外两种形式) = be close to pulling sth. out | pulls/ pulled 
令某人惊讶和如释重负的是 = to one’s surprise and relief 
点头同意v(三种形式) = nod in agreement | nods/ nodded/ nodding
过失；错误(单复数)= fault(s)
