litter -> v 乱扔  n 垃圾；废弃物
bottom -> n 底部；最下部
fisherman -> n 渔民；钓鱼的人
coal -> n 煤；煤块
ugly -> adj 丑陋的；难堪的
advantage -> n 优点；有利条件
cost / cost / cost -> v / pt / pp 花费    n 花费；价钱
wooden -> adj 木制的；木头的
plastic -> adj 塑料的  n 塑料；塑胶
takeaway -> n 外卖食物
bin -> n 垃圾箱
shark -> n 鲨鱼
fin -> n （鱼）鳍
cruel -> adj 残酷的；残忍的
harmful -> adj 有害的
be harmful to -> # 对……有害
at the top of -> # 在……顶部或顶端
chain -> n 链子；链条
the food chain -> # 食物链
ecosystem -> n 生态系统
industry -> n 工业；行业
law -> n 法律；法规
scientific -> adj 科学上的；科学的
take part in -> # 参加
afford -> v 承担得起（后果）；买得起
turn off -> # 关掉
reusable -> adj 可重复利用的；可再次使用的
pay for -> # 付费；付出代价
take action -> # 采取行动
transportation -> n 运输业；交通运输
recycle -> v 回收利用；再利用
napkin -> n 餐巾；餐巾纸
throw away -> # 扔掉；抛弃
put sth. to good use -> # 好好利用某物
pull ... down -> # 拆下；摧毁
upside down -> # 上下颠倒；倒转
gate -> n 大门
bottle -> n 瓶子
president -> n 负责人；主席；总统
inspiration -> n 灵感；鼓舞人心的人（或事物）
iron -> n 铁
work -> n （音乐、艺术）作品
metal -> n 金属
bring back -> # 恢复；使想起；归还
creativity -> n 创造力；独创性
WildAid -> 野生救援协会（美国）
WWF (World Wide Fund for Nature) -> 世界自然基金会
