一个驾照=a driver’s license 
担心安全=be worried about the safety 
不准抽烟/戒烟！ (v另外两种形式) = No / Give up smoking! | smokes/ smoked
黑烟= black smoke 
一个小宝宝=a tiny baby  
情不自禁地哭了起来(v另外两种形式)=can’t help crying | cries / cried
在田野上奔跑= run through the field 
给某人一个拥抱 n.=  give sb. a hug 
彼此拥抱(v三种形式) =hug each other |  hugs / hugged / hugging
举起/抬高某人或某物(v三种形式) = lift sb./sth. up | lifts/ lifted/ lifting 
乘电梯（厢式电梯）=take the lift 
让某人搭便车=give sb. a lift 
伤得严重= hurt badly
非常需要你的支持= need your support badly 
回嘴或顶嘴 = talk back 
一个噩梦=an awful dream 
后悔（做过）某事 (v三种形式) =regret (doing) sth. | regrets / regretted / regretting 
整首诗/整个社区或社团=the whole poem/community 
远离，避开=keep ...away from 
给机会做某事 = give chances / a chance to do sth. 
自己做决定=make one’s own decision(s) 
被教育或教导；接受教育(v另外两种形式) = be educated ; | educates/ educating
教育某人去做某事= educate sb. to do sth. 
设法完成某事；努力完成某事(v三种形式)= manage to do sth. | manages/ managed/managing 
应付他们自己的生活=manage their own lives 
在大多数的亚洲社会=in most Asian societies
妨碍学业=get in the way of the schoolwork 
考上大学/进入一个房间(v三种形式)= enter university / a room | enters / entered / entering
做出选择= make choices / a choice
只好做某事；除了做某事以外, 别无选择=have no choice but to do sth.
支持某人或某物；抚养或赡养某人(v三种形式) =support sb./sth. |  supports / supported / supporting 
支持某人或某物=in support of sb/sth.  
在当今社会中=in today’s society 
让某事被做= get sth. done 
不反对（做）某事=have nothing against (doing) sth. 
应该/可以被允许做某事 =should / may be allowed to do sth. 
被告知做某事= be told to do sth. 
