增加体重=put on
英镑=pound 
骄傲的=proud
偷v/pt/pp=steal stole stolen
看到某人正躺在= see sb. lying
公鸡谎称下了一个蛋= the cock lied that  it laid an egg
撒谎v/pt/pp/-ing=lie lied lied lying
躺v/pt/pp/-ing=lie lay lain lying
放，下蛋v/pt/pp/-ing=lay laid laid laying
摆放=lay out
位于，处于,原因是=lie in
长寿的秘诀是健康饮食=Long life lies in healthy eating habits.
花园 =garden
甜点=desserts
传统的 =traditional  
传统=tradition
对某人恶作剧=play a trick on sb.
用某物招待某人=treat sb. With sth.
在圣诞节=at Christmas
死的 =dead  
死亡=die
灭绝=die out
死于某种原因=die from/of
出差=On business
处罚v / n=punish v.    punishment n.
警告某人做/不做某事= warn sb. (not)to do sth.
目前=at present
龙舟节=the Dragon Boat Festival
泼水节=the Water Festival
春节=the Spring Festival
元宵节=The Lantern Festival
是否=whether or not
两周内/后= in two weeks
与...相似=be similar to 
冲洗=wash away     
逃走=run away     
去世= pass away    
 收拾  =take away
庆祝= celebrate
以...的形状=in the shape of
射击v/pt/pp= shoot  shot shot
多么有趣的节日 =how interesting the festival is!/what an interesting festival it is!
在 五月的第二个星期天=  on the second Sunday of May
事实上，实际上=actually 
相反=instead
……的重要性=the importance of doing ..
由某人写的小说 =novel written by sb.
提醒某人某事=remind sb. of sth.
人们不仅吃面条，他们还分发礼物=not only do people eat noddles, they also give out presents.(注意句式)
