幽默n . / adj. =humor/humorous
安静地= in silence
有用的=helpful/useful
亚洲=Asia
处理=deal with/do with
敢于做某事=dare to do
挤满人=be crowded with
人们很激动=the crowds are excited.
大量的关注=tons of attention
注意言行=be careful about what I say or do
要求某人做某事=require sb. to do sth.  /  request sb. (should)do sth.
采访某人=interview sb.
一个欧洲人/亚洲人/非洲人/蚂蚁/考试= a European/An Asian /an African/an ant/an examination
演讲=give a speech
公开地=in public
极少（表示频度）=seldom/hardly
对有影响=have influence on sb./sth.
缺席=be absent from
做某事失败=fail to do
总体而言=in general
简介=general introduction
介绍A给B= introduce A to B
他曾经很害羞，不是吗？ =He used to be shy,didn't he?
他没有在北京住过=He didn't use to live in Beijing.
你以前是做什么的？=What did you use to be?
你曾经戴眼镜吗？=Did you use to wear glasses?
科学成绩好= get good grades in science
变成……（颜色变化）=turn+颜色
他现在多么强壮啊！=How strong he is now！
这是多么明智的建议啊=What wise advice it is!
培养某种兴趣爱好=take up doing
做好准备=be prepared
正常的生活=normal life
…之路= road to pl.
坚持=keep on /fight on
穿任何我们喜欢的衣服=wear whatever we like
擅长做某事=do well in
做某事有困难 =have difficulties doing
造成问题=cause problems
下定决心做=make a decision to do
与某人沟通= have communication with sb.
一直很……、保持……  =  remain +adj.  如 remain silent、remain seated
剩下的（人或物）=the remaining
