humorous -> adj 有幽默感的；滑稽有趣的
silent -> adj 不说话的；沉默的
helpful -> adj 有用的；有帮助的
from time to time -> 时常；有时
score -> n&v  得分；进球
background -> n 背景
interview -> v 采访；面试  n 面试；访谈
Asian -> adj 亚洲（人）的
deal / dealt / dealt -> v / pt / pp 对付；对待
deal with -> 应对；对待
shyness -> n 害羞；腼腆
dare -> v 敢于；胆敢
crowd -> n 人群；观众
ton -> n 吨   pl 大量；许多
private -> adj 私人的；私密的
guard -> n 警卫；看守  v 守卫；保卫
require -> v 需要；要求
European -> adj 欧洲（人）的   n 欧洲人
African -> adj 非洲（人）的  n 非洲人
British -> adj 英国（人）的
speech -> n 讲话；发言
public -> n 民众   adj 公开的；公众的
in public -> 公开地；在别人（尤指生人）面前
ant -> n 蚂蚁
insect -> n 昆虫
seldom -> adv 不常；很少
influence -> v&n 影响
absent -> adj 缺席；不在
fail -> v 不及格；失败；未能（做到）
examination -> n 考试；审查
boarding school -> 寄宿学校
in person -> 亲身；亲自
exactly -> adv 确切地；精确地
pride -> n 自豪；骄傲
take pride in -> 为……感到自豪
proud -> adj 自豪的；骄傲的
be proud of -> 为……骄傲；感到自豪
general -> adj 总的；普遍的；常规地  n 将军
introduction ->  n 介绍
