whose -> adj&pron 谁的
truck -> n 卡车；火车
picnic -> n 野餐
rabbit -> n 兔；野兔
attend -> v 出席；参加
valuable -> adj 贵重的；很有用的；宝贵的
pink -> adj 粉红色的 n 粉红色
anybody -> pron 任何人
happening -> n 事件；发生的事情（常指不寻常的）
noise -> n 声音；噪音
policeman / policemen -> n / pl 男警察
wolf -> n 狼
uneasy -> adj 担心的；不安的
laboratory -> n 实验室
outdoors -> adv 在户外；在野外
coat -> n 外套；外衣
sleepy -> adj 困倦的；瞌睡的
land -> v 着陆；降落
alien -> n 外星人
run after -> # 追逐；追赶
suit -> n 西服；套装  v 适合
express -> v 表示；表达
at the same time -> # 同时；一起
circle -> n 圆圈  v 圈出
Britain / Great Britain -> 大不列颠
mystery -> n 奥秘；神秘事物
receive -> v 接待；接受；收到
historian -> n 历史学家；史学工作者
temple -> n 庙宇；寺院；圣殿
leader -> n 领导；领袖
midsummer -> n 仲夏；中夏
medical -> adj 医疗的；医学的
purpose -> n 目的；目标
prevent -> v 阻止；阻挠
energy -> n 力量；精力
position -> n 位置；地方
burial -> n 埋葬；安葬
honor / honour -> v 尊重；表示敬意 n 荣幸；荣誉
ancestor -> n 祖宗；祖先
victory -> n 胜利；成功
enemy -> n 敌人；仇人
period -> n 一段时间；时期
Stonehenge -> 巨石阵
