unexpected -> adj 出乎意料的；始料不及的
by the time ... -> # 在……以前
backpack -> n 背包；旅行包
oversleep / overslept / overslept -> v / pt / pp 睡过头；睡得太久
give ... a lift -> # 捎……一程
block -> n 街区
in line with -> # 与……成一排
worker -> n 工作者；工人
stare -> v 盯着看；凝视
disbelief -> n 不信；怀疑
above -> prep 在……上面  adv 在上面
burn / burnt burned / burnt burned -> v / pt / pp 着火；燃烧
burning -> adj 着火的；燃烧的
alive -> adj 活着；有生气的
airport -> n 机场
till -> prep&conj 到；直到
west -> adv 向西；朝西   adj 向西的；西部的   n 西；西方
cream -> n 奶油；乳脂
workday -> n 工作日
show up -> # 赶到；露面
bean -> n 豆；豆荚
market -> n 市场；集市
by the end of -> # 在（某时间点）以前
fool -> n 蠢人；傻瓜   v 愚弄
costume -> n （特定场合穿的）服装；装束
embarrassed -> adj 窘迫的；害羞的
costume party -> # 化妆舞会
announce -> v 宣布；宣告
spaghetti -> n 意大利面条
hoax -> n 骗局；恶作剧
sell out -> # 卖光
discovery -> n 发现；发觉
lady -> n 女士；女子
cancel -> v 取消；终止
officer -> n 军官；官员
believable -> adj 可相信的；可信任的
disappear -> v 消失；不见
embarrassing -> adj 使人害羞的（难堪的或惭愧的）
New Zealand -> 新西兰
Italy -> 意大利
Mars -> 火星
