soccer->n.足球足球运动
stadiumn.(pl.stadiumsorstadia)->n. pl. 体育场运动场
boxing->n.拳击（运动）
badminton->n.羽毛球运动
marathon->n.马拉松赛跑
event ->n.比赛项目；大事；公开活动
come along ->跟随到达进步赶快
ski->adj.滑雪的vi.滑雪
host ->vt.主办主持n.主人东道主节目主持人
track ->n.跑道足迹铁路轨道vt.&vi.追踪跟踪
track and field ->田径
gym->n.健身房体育馆
gymnastics ->n.体操（训练）
work out ->锻炼计算出解决
sweat->v.使出汗出汗弄湿 vi.出汗流汗n.汗水出汗
make it -> 获得成功准时到达
legend->n.传奇故事（或人物）；传说
athlete->n.运动员；运动健儿
master->n.高手主人 vt.精通掌握
set an example ->  树立榜样
honour->n.荣誉∶尊敬；荣幸
glory->n.荣誉；光荣；赞美
medal->n.奖章勋章
championship->n.锦标赛冠军赛冠军称号
champion->n.冠军优胜者
determination->n.决心；决定
apart->adv.分离分开成碎片
fall apart->破裂破碎崩溃
injure->vt.使受伤损害
injured->adj.受伤的有伤的
injury->n.伤害损伤
captain->n.（运动队）队长船长机长
lose heart ->丧失信心泄气
graceful->adj.优美的优雅的
strength->n.力量体力
failure->n.失败失败的人（或事物）
give up->放弃投降
compete->vi.竞争∶对抗
make sense ->有道理合乎情理表述清楚
pretend->vi.&vt.假装；装扮
pretend to do sth-> 假装做某事
even if/though-> 即使虽然
million->mm.一百万
cheat->vi.作弊舞弊vt.欺骗蒙骗n.敢骗手段骗子
audience->n.观众听众
positive->adj.积极的正面的乐观的肯定的
slim->adj.苗条的单薄的
diet->n.规定饮食日常饮食vi.节食
make a difference -> 有作用或影响
rather -> adv.相当有点儿
rather than-> 而不是
push-up->n.（especiallyNAmE）俯距撑
Cut…out->停止做（或使用、食用）剪下
now and then-> 有时偶尔
Compare…with/to…->与··········比较
jog->vi.慢跑n.慢跑
stress->n.压力；紧张；重音vt.强调重读使焦虑不安vi.焦虑不安
error->n.错误差错
