clean up -> # 打扫（或清除）干净
cheer -> v 欢呼；喝彩
cheer up -> # （使）变得更高兴；振奋起来
give out -> # 分发；散发
volunteer -> v 义务做；自愿做  n 志愿者
come up with -> # 想出；提出（主意、计划、回答等）
put off -> # 推迟
sign -> n 标志；信号
notice -> n 通知；通告；注意 v 注意到；意识到
hand out -> # 分发
call up -> # 打电话给（某人）；征召
used to -> # 曾经……；过去……
lonely -> adj 孤独的；寂寞的
care for -> # 照顾；非常喜欢
several -> pron 几个；数个；一些
strong -> adj 强烈的；强壮的
feeling -> n 感觉；感触
satisfaction -> n 满足；满意
joy -> n 高兴；愉快
owner -> n 物主；主人
try out -> # 参加……选拔；试用
journey -> n （尤指长途）旅行；行程
raise -> v 募集；征集
midnight -> n 午夜；子夜
alone -> adv 独自；单独
repair -> v 修理；修补
fix -> v 修理；安装
fix up -> # 修理；装饰
give away -> # 赠送；捐赠
take after -> # （外貌或行为）像
broken -> adj 破损的；残缺的
wheel -> n 车轮；轮子
letter -> n 信；函
Miss -> n 女士；小姐
set up -> # 建起；设立
disabled -> adj 丧失能力的；有残疾的
make a difference -> # 影响；有作用
blind -> adj 瞎的；失明的
deaf -> adj 聋的
imagine -> v 想象；设想
difficulty -> n 困难；难题
open -> v 开；打开
door -> n 门
carry -> v 拿；提；扛
train -> v 训练；培训
excited -> adj 激动的；兴奋的
training -> n 训练；培训
kindness -> n 仁慈；善良
clever -> adj 聪明的；聪颖的
understand / understood -> v 理解；领会 （过去式____________）
change -> v&n 变化；改变
interest -> n 兴趣；关注 n 使感兴趣；使关注
sir / Sir -> n 先生（用于正式信函中对不知名的男性收信人的称呼时，写为________）
madam / Madam -> n 夫人；女士（用于正式信函中对不知名的女性收信人的称呼时，写为________）
