matter -> n 问题；事情
What's the matter？ -> # 怎么了？出什么事了？
sore -> adj 疼痛的；酸痛的
have a cold -> # 感冒
stomachache -> n 胃痛；腹痛
have a stomachache -> # 胃痛
foot -> n 脚；足
neck -> n 颈；脖子
stomach -> n 胃；腹部
throat -> n 咽喉；喉咙
fever -> n 发烧
lie / lay -> v 躺；平躺（过去式_________）
lie down -> # 躺下
rest -> v&n  放松；休息
cough -> n&v 咳嗽
X-ray -> n X射线；X光
toothache -> n 牙痛
take one's temperature -> # 量体温
headache -> n 头痛
have a fever -> # 发烧
break -> n 间歇；休息
take breaks (take a break) -> # 休息
hurt / hurt -> v （使）疼痛；受伤 （过去式_________）
passenger -> n 乘客；旅客
off -> adv&prep 离开（某处）；不工作；从……去掉
get off -> # 下车
to one's surprise -> # 使……惊讶的是；出乎……的意料
onto -> prep 向；朝
trouble -> n 问题；苦恼
hit / hit -> v （用手或器具）击；打
right away -> # 立即；马上
get into -> # 陷入；参与
herself -> pron （she的反身代词）她自己
bandage -> n 绷带   v 用绷带包扎
press -> v 压；挤；按
sick -> adj 生病的；有病的
knee -> n 膝；膝盖
nosebleed -> n 鼻出血
breathe -> v 呼吸
sunburned -> adj 晒伤的
ourselves -> pron （we的反身代词）我们自己
climber -> n 登山者；攀登者
be used to -> # 习惯于……；适应于……
risk -> n & v 危险；风险；冒险
take risks (take a risk) -> # 冒险
accident -> n （交通）事故；意外遭遇
situation -> n 情况；状况
kilo = kilogram -> n 千克；公斤
rock -> n 岩石
run out (of) -> # 用尽；耗尽
knife / knives -> n 刀   pl  复数_________
cut off -> # 切除
blood -> n 血
mean / meant -> v 意思是；打算；意欲 （过去式_________）
get out of -> # 离开；从……出来
importance -> n 重要性；重要
decision -> n  决定；抉择
control -> n&v  限制；约束；管理
be in control of -> # 掌管；管理
spirit -> n 勇气；意志
death -> n 死；死亡
give up -> # 放弃
nurse -> n 护士