yard -> n 院子
yard sale -> 庭院拍卖会
sweet -> adj 甜蜜的;甜的;含糖的
memory -> n 记忆;回忆
cent -> n 分;分币
toy -> n 玩具
bear -> n 熊
maker -> n 生产者;制订者
bread maker -> 面包机
scarf -> n 围巾;披巾;头巾
soft -> adj 软的;柔软的
soft toy -> 软体玩具;布绒玩具
check -> v&n 检查;审查
check out -> 察看;观察
board -> n 板;木板
board game -> 棋类游戏
junior -> adj 地位（或职位、级别）低下的
junior high school -> 初级中学
clear -> v 清理;清除
clear out -> 清理;丢掉
bedroom -> n 卧室
no longer -> 不再;不复
own -> v 拥有;有
railway -> n 铁路;铁道
part -> v 离开;分开
part with -> 放弃、交出（尤指不舍得的东西）
certain -> adj 某种;某事;某人
as for -> 至于;关于
honest -> adj 诚实的;老实的
to be honest -> 说实在的
while -> n 一段时间;一会儿
truthful -> adj 诚实的;真实的
hometown -> n 家乡;故乡
nowadays -> adv 现今;现在;目前
search -> v&n 搜索;搜查
among -> prep 在（其）中;……之一
crayon -> n 彩色铅笔（或粉笔、蜡笔）
shame -> n 羞耻;羞愧;惭愧
regard -> v 将……认为; 把……视为;看待
count -> v 数数
century -> n 百年;世纪
according to -> 依据;按照
opposite -> prep 与……相对;在……对面 adj 对面的;另一边的
especially -> adv 尤其;特别;格外
childhood -> n 童年;幼年
consider -> v 注视;仔细考虑
close to -> 几乎;接近
hold / held / held -> v 拥有;抓住 / 过去式/ 过去分词
