amusement -> n 娱乐
amusement park -> 游乐场
somewhere -> adv 在某处;到某处
camera -> n 照相机，摄像机，摄影机
invention -> n 发明;发明物
invent -> v 发明;创造
unbelievable -> adj 难以置信的;不真实的
progress -> n v 进步;进展
rapid -> adj 迅速的;快速的
unusual -> adj 特别的;不寻常的
toilet -> n 坐便器
encourage -> v 鼓励
social -> adj 社会的
peaceful -> adj 和平的;安宁的
tea art -> 茶艺
performance -> n 表演;演出
perfect -> adj 完美的; 完全的
tea set -> 茶具
itself -> pron 它自己
collect -> v 收集;采集
a couple of -> 两个;一对;几个
German -> adj 德国的;德语的;德国人的 n 德语;德国人
theme -> n 主题
ride -> n 供乘骑的游乐设施;短途旅程
province -> n 省份
thousand -> num 一千
thousands of -> 数以千计的;许许多多的
on the one hand .. on the other hand .. -> 一方面..另一方面..
safe -> adj 安全的;无危险的
simple -> adv 仅仅;只;不过
fear -> v&n 害怕;惧怕
whether -> conj 不管...（还是）;或者....（或者）;是否
Indian -> adj 印度的 n 印度人
Japanese -> adj 日本的;日本人的;日语的 n 日本人;日语
fox -> n 狐狸
all year round -> 全年
equator -> n 赤道
whenever -> conj 在任何...的时候;无论何时
spring -> n 春天
mostly -> adv 主要地;通常
location -> n 地点;位置
National Science Museum -> 国家科学博物馆
International Museum of Toilets -> 国际厕所博物馆
Hangzhou National Tea Museum -> 杭州国家茶博物馆
Donald Duck -> 唐老鸭
Disneyland -> 迪斯尼乐园
Disney Cruise ->  迪斯尼油轮
the Terracotta Army -> 兵马俑
the Bird's Nest -> 鸟巢
Singapore -> 新加坡
Southeast Asia -> 东南亚
Night Safari -> 夜间野生动物园
