allow -> v 允许；准许
wrong -> adj 有毛病的；错误的
What's wrong? -> # 哪儿不舒服？
look through -> # 快速查看；浏览
guess -> v 猜测；估计
deal -> n 协议；交易
big deal -> # 重要的事
work out -> # 成功地发展；解决
get on with -> # 和睦相处；关系良好
relation -> n 关系；联系；交往
communication -> n 交流；沟通
argue -> v 争吵；争论
cloud -> n 云；云朵
elder -> adj 年纪较长的
instead -> adv 代替；反而；却
whatever -> pron 任何；每一
nervous -> adj 焦虑的；担忧的
offer -> v 主动提出；自愿给予
proper -> adj 正确的；恰当的
secondly -> adv 第二；其次
communicate -> v 交流；沟通
explain -> v 解释；说明
clear -> adj 清楚易懂的；晴朗的
copy -> v 抄袭；模仿；复制；复印
return -> v 归还；回来；返回
anymore -> adv （常用于否定句和疑问句末）再也（不）；（不）再
member -> n 成员；分子
pressure -> n 压力
compete -> v 竞争；对抗
opinion -> n 意见；想法；看法
skill -> n 技艺；技巧
typical -> adj 典型的
football -> n （美式）橄榄球；足球
cut out -> # 删除；删去
quick -> adj 快的；迅速的；时间短暂的
continue -> v 持续；继续存在
compare -> v 比较
compare ... with -> # 比较；对比
crazy -> adj 不理智的；疯狂的
push -> v 鞭策；督促；推动
development -> n 发展；发育；成长
cause -> v 造成；引起
usual -> adj 通常的；寻常的
in one's opinion -> # 依……看
perhaps -> adv 可能；大概；也许