咳嗽v.= cough
乘客=passenger
胃= stomach
躺(原形，过去式，-ing)=lie lay lying
按压=press
呼吸v. / 呼吸n. = breathe / breath
hit过去式=hit
Hurt过去式=hurt
膝盖=knee
情况，状况n.=situation
千克=kilo
血(n./v.)= blood/bleed
刀（单复数）=knife  knives
我们自己=ourselves
决定n.=decision
做决定 =make decisions
控制v. =control
意志，精神 n. =spirit
牙齿（复数）=teeth
足（复数）=feet
死亡n./v./过去式/-ing/adj.=death/ die/died/dying/ dead    
护士n. =nurse
意味着，意思是v. = mean
讲太多话= talk too much
感冒 = have a cold
嗓子疼=have a sore throat
带蜂蜜的热茶=hot tea with honey
胃痛=have a stomachache
躺下=lie down
量体温=take one’s temperature
发烧=have a fever
休息=take breaks
受伤=get hurt/be hurt
自己受伤=hurt oneself
以同样的姿势坐=sit in the same way
使.....惊讶的 =to one’s surprise
看见某人正在做某事=see sb. Doing
沿着... =go along
大声呼救=shout for help
没有多想=without thinking twice
期待某人做某事=expect sb. To do
由于=thanks to 
被...救=be saved by
及时=in time
考虑自己=think about
救命=save a life
摔倒=fall down
感到恶心=feel sick
头部受打击= get hit on the head
陷入麻烦=get into trouble
立即马上 =right away
一个生病的男孩= a sick boy
生病（2种d表达）=be ill/be sick
晒伤=get sunburned
下车=get off
习惯于做某事=be used to doing
曾经做某事=used to do
被用来做某事=be used to do
冒险=take risks
一次事故=an accident
在危险/困难的情况下=in a dangerous/difficult situation
呼吸困难=have problem breathing
当做某事时=when doing
这样的话就=so that
坚持做某事=keep on doing
切除=cut off
用尽=run out of
放弃=give up
从...中出来=get out of
做某事的重要性=the importance of doing
打算做某事（mean）=mean to do
意味着做某事（mean）=mean doing
mean过去式=meant
control过去式 -ing= controlled  controlling
