credulous -> adj. 轻信的
improbable -> adj. 不大可能的
obscure -> adj. 不起眼的
maidservant -> n.   女仆，女佣
presume -> v.   假定
wickedly -> adv. 心眼坏地，居心叵测地
plot -> v.   密谋
downfall -> n.   倒台，垮台
naive -> adj. 天真的
unacceptable -> adj. 不能接受的
conspire -> v.   （事件）巧合促成
incredible -> adj. 难以置信的
scorn -> n.   嘲弄，挖苦
acquaint -> v.   使了解
reunite -> v.   使团聚
assume -> v.   假定，认为
express -> n.   快车；adj. 高速的
punctual -> adj. 准时的
condition -> v.   使习惯于
unshakable -> adj. 不可动摇的
faith -> n. 信任
cancel -> v.   取消
exceptionally -> adv. 例外地
dislocate -> v.   打乱（计划等）
blame -> v.   责怪
consult -> v.   请教，查阅
direct -> adv. 径直地
odd -> adj. 奇怪的，异常的
reflect -> v.   细想
advantage -> n.   优势
mighty -> adj. 强大的，有力的
dawdle -> v.   慢吞吞地动或做
chug -> v.   咔嚓咔嚓地响
lodge -> v.   提出
complaint -> n.   抱怨
triumph -> n.   胜利
asterisk -> n.   星号（*）
conduct -> v.   引向，引导
calendar -> n.   历法，日历
historian -> n.   历史学家
unique -> adj. 无与伦比的
steadily -> adv. 不断地
solely -> adv. 唯一地
video -> n.   录像
CD-ROOM -> n.   （只读）光盘驱动器
bewilder -> v.   令人眼花缭乱
deduce -> v.   推断，推理
scanty -> adj. 不足的，贫乏的
clue -> n.   线索
insignificant -> adj. 不重要的
shed -> v.   使流出，泻
advent -> n.   出现，到来，来临
agriculture -> n.   农业
assumption -> n.   假定，设想
dot -> n.   小圆点
symbol -> n.   符号
engrave -> v.   雕刻
ivory -> n.   象牙制品
mammoth -> n.   （古）长毛象
tusk -> n.   獠牙，长牙，象牙
nomad -> n.   游牧民
correlate -> v.   使相互联系
phase -> n.   月相，天相
primitive -> adj. 原始的
depict -> v.   描画，描绘
rough -> adj. 崎岖不平的
boulder -> n.   大石块
pit -> v.   使得坑坑洼洼
perturb -> v.   使不安
underestimate -> v.   低估
swerve -> v.   急转变
scoop -> v.   挖出
hammer -> v.   （用锤）击打，锤打
ominously -> adv. 有预兆的，不祥的
rip -> v.   划破，撕，扯
petrol -> n.   汽油
stretch -> n.   一大片（平地或水）
obstacle -> n.   障碍
clump -> n.   丛，簇
fissure -> n.   （石，地的）深缝
renew -> v.   重复
pleading -> n.   恳求
gear -> n.   汽车排档
astride -> prep.骑，跨
crack -> n.   缝隙
zigzag -> n.  “之”字形
shallow -> adj. 浅的
grind (ground, ground) -> v.   磨擦
halt -> n.   停
dashboard -> n.   （汽车上的）仪表盘
hoax -> n.   骗局，戏弄
deception -> n.   欺骗，骗局
self-respecting -> adj. 自重的
indulge -> v.   使沉迷
pneumatic -> adj. 气动的
drill -> n.   钻
silly -> adj. 无意义的，无聊的
advance -> adj. 预先的，事先获得的
archway -> n.   拱形门楼
remonstrate -> v.   规劝，告诫
ironically -> adv. 讽刺地
permission -> n.   许可
grant -> v.   同意，准予
