influence -> v.   影响
pride -> v.   骄傲
taste -> n.   鉴赏力
exert -> v.   施加
subtle -> aj.  微妙的，难以捉摸的
advertiser -> n.   做广告的人
classify -> v.   分类
magic -> adj. 有奇妙作用
sample -> n.   样品
devise -> v.   设计，想出
capture -> v.   吸引，赢得
manufacturer -> n.   生产厂家，制造商
wheelbarrow -> n.   独轮手推车
boot -> n.  （汽车尾部的）行李箱
ingredient -> n.   配料
crane -> n.   起重机
anticipate -> v.   预期，预料
philosopher -> n.   哲学家
wisdom -> n.   智慧
priest -> n.   牧师
spiritual -> adj. 精神上的
grudge -> v.   不愿给，舍不得给
surgeon -> n.   外科大夫
passer-by -> n.   过路人（复数 passers-by)
dignity -> n.   尊严
deliberately -> adv. 故意地
consequence -> n.   后果，结果
afflict -> v.   使苦恼，折磨
ease -> n.   容易
nature -> n.   大自然
contempt -> n.   蔑视的
envious -> adj. 嫉妒的
wares -> n.   货物，商品
anchor -> v.   停航下锚
deck -> n.   甲板
silverware -> n.   银器
tempt -> v.   吸引；引诱
bargain -> v.   讨价还价
disembark -> v.   下船上岸
assail -> v.   纠缠
marble -> n.   小玻璃球
inscribe -> v.   刻写，雕
favour -> n.   好处，优惠
gesticulate -> v.   （讲话时）打手势
outrageous -> adj. 出人预料的；令人不悦的
thrust -> v.   硬塞给
largely -> adv. 在很大程度上
comic -> adj. 喜剧的，可笑的
universal -> adj. 普通的
comedian -> n.   滑稽演员，喜剧演员
distasteful -> adj. 讨厌的
pester -> v.   一再要求，纠缠
dread -> v.   惧怕
recovery -> n.   康复
plaster -> n.   熟石膏
console -> v.   安慰，慰问
hobble -> v.   瘸着腿走
compensate -> v.   补偿
mumble -> v.   喃喃而语
labourer -> n.   劳动者
overnight -> adv. 一夜期间
hay -> n.   干草
corn -> n.   谷物
moonlight -> n.   月光
conscientious -> adj. 认真的
suspect -> v.   怀疑
desert -> v.   （军队中）开小差
regiment -> n.   （军队）团
action -> n.   战斗
recluse -> n.   隐士
