lovable -> adj. 可爱的
eccentric -> n.   （行为）古怪人
disregard -> v.   不顾，漠视
convention -> n.   习俗，风俗
conscious -> adj. 感觉到的，意识到的
invariably -> adv. 总是，经常地
routine -> n.   常规；惯例
shrewd -> adj. 精明的
eccentricity -> n.   怪僻
legendary -> adj. 传奇般的
snob -> n.   势利小人，谄上欺下的人
intensely -> adv. 强烈地
bedraggled -> adj. 拖泥带水的
dump -> v.   把……砰的一声抛下
apologetic -> adj. 道歉的
reprimand -> v.   训斥
stage -> v.   暗中策划
elaborate -> adj. 精心构思的
salvage -> v.   救助，营救；打捞
Barents -> n.   巴伦支（海）
sunken -> adj. 沉没的
cargo -> n.   货物
bullion -> n.   金条；银条
scour -> v.   彻底搜索
chest -> n.   大箱子
contents -> n.   （复数）所装的东西
belongings -> n.   （复数）所有物
item -> n.   物件
cruiser -> n.   巡洋舰
find -> n.   找到的物品
log book -> 航海日志
piece -> v.   拼成整体
convoy -> n.   护航
torpedo -> v.   用鱼雷攻击
submarine -> n.   潜水艇
naval -> adj. 海军的
ministry -> n.   （政府的）部
prelude -> n.   序幕，前奏
unforeseen -> adj. 意料之外的
series -> n.   系列
catastrophe -> n.   大祸，灾难
crockery -> n.   陶器，瓦器
suburb -> n.   郊区
collide -> v.   猛撞
learner -> n.   初学者
panic -> n.   惊慌，恐慌
windscreen -> n.   （汽车的）挡风玻璃
alongside -> prep.在……的旁边，与……并排
slide (slid, slid) -> v.   滑
stray -> adj. 迷失的，离群的
confusion -> n.   混乱
greedily -> adv. 贪婪地
devour -> v.   狼吞虎咽地吃
antique -> n.   古董，古玩
fascination -> n.   魅力，迷惑力
forbidding -> adj. 望而生畏的，望而却步的
muster -> v.   鼓起
pretentious -> adj. 自命不凡的，矫饰的
labyrinth -> n.   迷宫
musty -> adj. 陈腐的，发霉的
rarity -> n.   稀世珍品
assorted -> adj. 各式各样的
junk -> n.   破烂货，废品
litter -> v.   杂乱地布满
dedicated -> adj. 专心致志的
bargain hunter -> 到处找便宜货买的人
dealer -> v.   商人
cherish -> v.   期望，渴望
amply -> adv. 足够地
masterpiece -> n.   杰作
mere -> adj. 仅仅的
prise -> v.   撬开
carve -> v.   镌刻
dagger -> n.   短剑，匕首
miniature -> adj. 小巧的，小型的
composition -> n.   构图
justice -> n.   正义，公正；司法
court -> n.   法院
law -> n.   法律
innocence -> n.   无辜
undertake -> v.   承担；着手做
arduous -> adj. 艰苦的，艰难的
abstract -> adj. 抽象的
concept -> n.   概念，观念
mete out -> 给予，处置
interference -> n.   干涉
accord -> n.   一致
premises -> n.    房屋
convert -> v.   转变，改变
disused -> adj. 不再用的，废弃的
fireplace -> n.   壁炉
muffle -> v.   捂住，厌抑
chip -> v.   砍，削，凿
blacken -> v.   使变黑
emerge -> v.   （从某处）出现
