smash-and-grab -> n.   砸橱窗抢劫
arcade -> n.   有拱廊的街道（两旁常设商店）
Piccadilly -> n.   皮卡迪利大街
jewllery -> n.   珠宝（总称）
necklace -> n.   项链
ring -> n.   戒指
background -> n.   背景
velvet -> n.   天鹅绒，丝绒
headlight -> n.   （汽车等）前灯
blare -> v.   发嘟嗜声，吼叫
staff -> n.   全体工作人员
raid -> n.   偷袭
scramble -> n.   偷袭
scramble -> v.   爬行
fantastic -> adj. 非常大的
ashtray -> n.   烟灰缸
mutilate -> v.   使残缺不全
chew -> v.   咀嚼
microwave -> n.   微波，微波炉
oven -> n.   炉灶
safekeeping -> n.   妥善保管
Newcastle -> n.   纽卡斯尔（英国港市）
identify -> v.   鉴定，识别
spokeswoman -> n.   女发言人
monastery -> n.   寺院，修道院
St. Bernard ->      圣伯纳德
pass -> n.   关隘
watchdog -> n.   看门狗
rashly -> adj. 莽撞地，冒失地
enclosure -> n.   围场，圈地
monk -> n.   和尚
privacy -> n.   清静，隐居
skier -> n.   滑雪者
Easter -> n.   复活节
fascinate -> v.   迷住，吸引住
affectionate -> adj. 充满深情，柔情的
mysterious -> adj. 神秘的，难以理解的
submissive -> adj. 服从的，顺从的
feline -> adj. 猫的
independence -> n.   独立，独立性
high-rise -> adj. 高层的
windowsill -> n.   窗槛
paratrooper -> n.   伞兵
squirrel -> n.   松鼠
air-resistance -> n.   空气阻力
impact -> n.   冲击力
Southampton -> n.   南安普敦（英国港市）
colossal -> adj. 庞大的
watertight -> adj. 不漏水的
compartment -> n.  （轮船的）密封舱
flood -> v.   充满水
float -> v.   漂浮，飘浮
tragic -> adj. 悲惨的
liner -> n.   班船
voyage -> n.   航行
iceberg -> n.   冰山
lookout -> n.   了望员
collision -> n.   碰撞
narrowly -> adv. 刚刚，勉强地
miss -> v.   避开
slight -> adj. 轻微的
tremble -> v.   震颤
faint -> adj. 微弱的
horror -> n.   恐惧
abandon -> v.   抛弃
plunge -> v.   投入，跳入
lifeboat -> n.   救生船