boundary -> n.   界线；边界
pump -> v.   用泵抽
overtake -> v.   突然降临
backwater -> n.   回水河汊
predecessor -> n.   前任，前辈
meadow -> n.   草地，草场
crown -> v.   给……戴花环
holly -> n.   一种冬青植物
wreath -> n.   花环
occurrence -> n.   偶发事件
proportion -> n.   部分
site -> v.   使位于
spell -> v.   招致，带来
stall -> n.   牲口棚
attic -> n.   顶楼
sweeping -> adj. 范围广大的
critical -> adj. 危急的
juncture -> n.   时刻，关头
raft -> n.   木筏
unduly -> adv. 过度地
foundations -> n.   地基
stoutly -> adv. 牢固地，粗壮的
submerge -> v.   浸没
grapple -> v.   抓住
alien -> adj. 异国的，外国的
emigrate -> v.   移居（国外）
absorb -> v.   全神贯注于
embedded -> adj. 扎牢的
mortally -> adv. 致命地
comprehensive -> adj. 广泛的；丰富的
milestone -> n.   里程碑
territory -> n.   领地；地区
milometer -> n.   计程表
spire -> n.  （教堂的）塔尖
retrace -> v.   返回，重走
stumble -> v.   趔趄地走
horizon -> n.   地平线
reservoir -> n.   水库
life -> n.   电梯
monstrous -> adj. 极大的，可怕的
negligence -> n.   粗心大意
lurk -> v.   潜藏
hinder -> v.   妨碍
fingerprint -> n.   指纹
chaos -> n.   混乱，无秩序
inconceivable -> adj. 不可思议的
veritable -> adj. 真正的，地地道道的
magpie -> n.   喜欢收藏物品的人
prudent -> adj. 谨慎的
composure -> n.   镇静，沉着
intruder -> n.   入侵者（尤指欲行窃者）
toss -> v.   扔
discard -> v.   丢
discard -> v.   丢弃
constable -> n.   警察
ransack -> v.   洗劫
balcony -> n.   阳台
fussy -> adj. 大惊小怪的，小题大作的
amass -> v.   积聚
indiscriminate -> adj. 不加选择的
clutter -> n.   一堆杂物
string -> n.   细线
requisite -> n.   必需品
mania -> n.   癖好
sketch -> n.   草图，图样
remote -> adj. （机会，可能性）少的，小的
strong-minded -> adj. 意志坚强的
relaxation -> n.   休息，娱乐
verify -> v.   查证，核实
bearing -> n.    关系，联系
like-minded -> adj. 志趣相投的
specimen -> n.   标本
constructively -> adv. 有益的，积极的
contented -> adj. 心满意足的
boredom -> n.    烦恼，无聊
punctuality -> n.   准时
rural -> adv. 农村的
disregard -> v.   不顾，无视
intellectual -> n.   知识分子
abstruse -> adj. 深奥的
coordinate -> v.   协调
reproach -> v.   责备
puncture -> v.   刺破（轮胎）
diversion -> n.   改道，绕道
trial -> n.   讨厌的事，人
fraction -> n.   很小一点儿
flourish -> n.    挥舞（打手劳）
microscopic -> adj. 微小的
adamant -> adj. 坚定的，不动摇的
