prize -> adj. 珍贵的，宝贵的
tie -> v.   拴，系
theft -> n.   偷盗行为，偷盗案
accuse -> v.   指控
deny -> v.   否认
ashamed -> adj. 感到羞耻，惭愧
apologize -> v.   道歉
dye -> v.   染
suspension -> n.   悬，吊
agreeable -> adj. 宜人的
situation -> n.   地点，地方
locate -> v.   位于
immortal -> adj. 永生的，流芳百世的
Brooklyn -> n.   布鲁克林（纽约一区名）
Staten -> n.   斯塔顿（岛）
span -> n.   跨度
cable -> n.   缆索
concrete -> n.   混凝土
suspend -> v.   悬挂
length -> n.   根，段
estimate -> v.   估计
capacity -> n.   承受量
immensity -> n.   巨大
elegant -> adj. 优美别致的
faintly -> adv. 微细地
current -> n.   电流
sculpture -> n.   雕塑
mistaken -> adj. 错误的
gallery -> n.   美术馆
exhibit -> n.   展品，陈列品
oddly -> adv. 古怪的
attach -> v.   连，系
sphere -> n.   球体
magnetize -> v.   使磁化
repel -> v.   排斥
flicker -> v.   闪烁
emit -> v.   放射
flash -> v.   闪光
prehistoric -> adj. 史前的，老掉牙的
electronic -> adj. 电子的
peculiar -> adj. 奇异的
shock -> v.   令人震惊，刺激人
emotionally -> adv. 事情上
dear -> adj. 亲爱的，珍贵的；昂贵的
kidnapper -> n.   绑架者，拐骗者
considerable -> adj. 相当大的
wealthy -> adj. 富的，有钱的
orderly -> adj. 有规律的
disappearance -> n.   失踪
anonymous -> adj. 匿名的
ransom -> n.   赎金
cardboard -> n.   硬纸板
withdraw(withdrew, withdrawn) -> v.   （从银行）取钱
punctually -> adv. 准时地
astound -> v.   使吃惊
pioneer -> n.   先驱
lord -> n.   对（英国）贵族的尊称；勋爵
Calais -> n.   加来（法国港市）
overland -> adj. 陆上的
