notoriously -> adv. （尤指因坏事）众所周知地
full-time -> adj. 专职的
technician -> n.   技师
software -> n.   软件
IBM -> （美国）国际商用机器公司（International Business Machines）
DOS -> 磁盘操作系统（Disk Operating System）
Microsoft -> n.   （美国）微软公司
user-friendly -> adj. 容易操作的，好用的
mainframe -> n.   主机，中央处理机
multimedia -> adj. 多媒体的
alternative -> adj. 选择的
diagnose -> v.   诊断
relieve -> v.   减轻
accountant -> n.   会计
repetitive -> adj. 重复的
clerical -> adj. 办公室工作的
Internet -> n.   国际交互网
network -> n.   网络
permanent -> adj. 永久的
tint -> v.   给……染色
delicate -> adj. 淡色的
shade -> n.   色度
observant -> adj. 观察力敏锐的
dispel -> v.   驱散，消除
outlandish -> adj. 稀奇古怪的
acquisition -> n.   获得
cosmetic -> n.   化妆品
outrageous -> adj. 无理的，令人不能容忍的
fanciful -> adj. 想像出来的
insoluble -> adj. 不可溶解的
prompt -> v.   敦促，激励
exclusive -> adj. 专售高档商品的
syllable -> n.   音节
bewilderment -> n.   迷惑，糊涂
freckle -> n.   雀斑
evidently -> adv. 显然的，明显地
weird -> adj. 奇异的，古怪的
concoction -> n.   调制品
intoxicate -> v.   陶醉，得意忘形
blank -> adj. 无表情的，茫然的
discreetly -> adv. 谨慎地
clutch -> v.   抓住
adorn -> v.   装饰，打扮
evolve -> v.   逐渐形成
high-handed -> adj. 高压的，专横的
incompetent -> adj. 不够格的，不称职的
over-zealously -> adv. 过分热情地
safeguard -> v.   保护
parliamentary -> adj. 国会的
qalified -> adj. 合格的
grievance -> n.   不平，冤屈
Justiteombudsman -> n.   （瑞典的）司法特派员
ombudsman -> n.  （瑞典和英国的）司法特派员
secretive -> adj. 保密的
correspondence -> n.   来往信件
alter -> v.   改变
accusation -> n.   谴责，指控
ascertain -> v.   查出，查明
prejudiced -> adj. 有偏见的，不公平的
prompt -> adj. 即时的
insect -> n.   昆虫
wage -> v.   进行（斗争）
contaminate -> v.   弄脏
provocation -> n.   惹怒
spider -> n.   蜘蛛
wasp -> n.   黄蜂
moth -> n.   飞蛾
ant -> n.   蚂蚁
revulsion -> n.   厌恶
horde -> n.   群
uncanny -> adj. 神秘的，不可思议的
erase -> v.   擦，抹去
praying mantis -> 螳螂
entranced -> adj. 出神的
beetle -> n.   甲虫
sheltered -> adj. 伤不着的，无危险的
luscious -> adj. 甘美的
cluster -> n. 一簇
aphid -> n.   蚜虫
underside -> n.   底面，下侧
colony -> n.   一群
sticky -> adj. 粘的
scurry -> v.   小步跑
swarm -> v.   聚集
ingenuity -> n.   机灵
astronomy -> n.   天文学
relative -> adj. 相对的
infinitely -> adv. 无限地，无穷地
solar -> adj. 太阳系的
Venus -> n.   金星
Mars -> n.   火星
orbit -> n.   运行轨道
astronomical -> adj. 天文学的
generate -> v.   产生
particle -> n.   微粒，粒子
Jupiter -> n.   木星
blot -> v.   遮暗
analyse -> v.   分析
bacteria -> n.   细菌
oxygen -> n.   氧气
realm -> n.   领域
endeavour -> v.   努力
