guilty -> adj. 犯罪的，违法的
tolerant -> adj. 宽容的
declare -> v.   申报
hardened -> adj. 有经验的
professional -> adj. 职业的，专业的
smuggler -> n.   走私者
officious -> adj. 爱管闲事的
confidently -> adv. 自信地
dreadful -> adj. 可怕的，一团糟的
pounce -> v.   猛抓，扑住
perfume -> n.   香水
sarcastically -> adv. 讽刺地
exempt -> adj. 被免除的
duty -> n.   税
gel -> n.   凝胶
mixture -> n.   混合物
unscrew -> v.   拧开
nostril -> n.   鼻孔
chalk -> n.   粉笔
baggage -> n.   行李
desert island -> 荒岛
unrealistic -> adj. 不真实
paradise -> n.   天堂，乐士
wretched -> adj. 可怜的，艰苦的
starve -> v.   挨饿
element -> n.   成分
opportunity -> n.   机会
coral -> n.   珊瑚
Virgin Islands -> 维尔京群岛
Miami -> n.   迈阿密（美国最南的城市）
dinghy -> n.   救生筏，小船
Caribbean -> n.   加勒比海
spear gun -> 捕鱼枪
lobster -> n.   龙虾
tanker -> n.   油轮
genuinely -> adv. 由衷地
Robinson Crusoe -> 鲁滨孙.克鲁索（小说《鲁滨孙漂流记》主人公）
costume -> n.   化装服
consist -> v.   由……组成
sheet -> n.   被单
effective -> adj. 有明显效果的，有作用的
metre -> n.   电表
pace -> n.   一步
lee (fled, fled) -> v.   逃走
slam -> v.   砰地关上
gangster -> n.   歹徒,强盗
Chicago -> n.   芝加哥(美国城市)
protection -> n.   保护
promptly -> adv. 准时地
destroy -> v.   毁掉;消灭
remarkable -> adj. 不寻常的
hand -> n.   帮,团伙
Florence -> n.   佛罗伦萨(意大利城市)
city-state -> n.   (古代)城邦
hire -> v.   租出,雇给
prince -> n.   君主,诸候
Florentine -> n.   佛罗伦萨人
funeral -> n.   葬礼
dedicate -> v.   奉献,题献给
memory -> n.   纪念
valiant -> adj. 英勇的
appreciate -> v.   欣赏，感激
pocket money -> 零用钱
thrifty -> adj. 节约的
nephew -> n.   侄子，外甥
bounce -> v.   弹起，跳起
pavement -> n.   人行道
stick (stuck, stuck) -> v.   卡住，夹住，不能再动
brigade -> n.   旅，（消防）队
grease -> n.   润滑油
