Boxing -> n.   拳击
boxer -> n.   拳击手
bare -> adj. 赤裸的
prizefighter -> n.   职业拳击手（尤指古时赤手拳击手）
crude -> adj. 粗野的
marquis -> n.   侯爵
technically -> adv. 严格根据法律意义地
science -> n.   科学
popularity -> n.   名望
adore -> v.   崇拜，爱戴
alike -> adv. 一样地
fame -> n.   名声
eminent -> adj. 著名的，杰出的
bitterly -> adv. 厉害地
bet -> v.   打赌
academy -> n.   专业学校
extravagant -> adj. 浪费的，奢移的
poverty -> n.   贫困
run (ran, run) -> v.   （戏剧，电影等）连演，连映
lines -> n.   （剧本中的）台词
part -> n.   剧中的角色，台词
falter -> v.   支吾，结巴说
cast (cast, cast) -> v.   连派……扮演角色
role -> n.   角色
aristocrat -> n.   贵族
imprison -> v.   关押
Bastille -> n.   巴士底狱
gaoler -> n.   监狱长，看守
colleague -> n.   同事
curtain -> n.   （舞台上的）幕布
reveal -> v.   使显露
cell -> n.   单人监房，监号
blank -> adj. 空白的
squint -> v.   眯着（眼）看，瞄
dim -> adj. 昏暗
sire -> n.   （古用法）陛下
proceed -> v.   继续进行
poison (title) -> n.   毒药
illogical -> adj. 不合逻辑的，无章法的
octopus -> n.   章鱼
delicacy -> n.   美味，佳肴
repulsive -> adj. 令人反感的，令人生厌的
stomach -> n.   胃
turn -> v.   感到恶心，翻胃
fry -> v.   油炸
fat -> n.  （动物，植物）油
abuse -> n.   辱骂，责骂
snail -> n.   蜗牛
luxury -> n.   奢移品，珍品
associate -> v.   联想到
despise -> v.   鄙视
appeal -> v.   引起兴致
shower -> n.   阵雨
stroll -> n.   溜达，散步
impulse -> n.   冲动
dozen -> n.   12个，一打
fancy -> v.   喜爱，喜欢
skeleton -> n.   骷髅
seemingly -> adv. 表面上地
respectable -> adj. 体面的，雅观的
conceal -> v.   隐藏，隐瞒
vivid -> adj. 生动的
dramatic -> adj. 令人激动的，扣人心弦的
ruin -> v.   毁坏
heroine -> n.   女主人公
fiction -> n.   小说
varying -> adj. 不同的
medicine -> n.   医学
guestroom -> n.   （家庭中的）来客住房
unpack -> vt.  （从箱中）取出
stack -> v.   （整齐地）堆放，排放
underclothes -> n.   内衣
drawer -> n.   抽屉
petrify -> v.   使惊呆
dangle -> v.   悬挂
sway -> v.   摇摆
unsympathetic -> adj. 不表同情的，无动于衷的
medical -> adj. 医学的
impressive -> adj. 给人深刻印象的
steamship -> n.   蒸汽轮船
vessel -> n.   轮船，大木船
era -> n.   时期，时代
Java -> n.   爪哇（印度尼西亚一岛）
rudder -> n.   舵
roll -> v.   颠簸，摇摆
steer -> v.   掌握方向
temporary -> adj. 临时的
plank -> n.   大块木板
fit -> v.   安装
Equator -> n.   赤道
delay -> n.   耽误
