puma -> n.   美洲狮
spot -> v.   看出，发现
evidence -> n.   证据
accumulate -> v.   积累，积聚
oblige -> v.   使……感到必须
hunt -> n.   追猎；寻找
blackberry -> n.   黑莓
human being -> 人类
corner -> v.   使走投无路，使陷入困境
trail -> n.   一串，一系列
print -> n.   印痕
cling -> v.   粘
convince -> v.   使……信服
somehow -> adv. 不知怎么搞地，不知什么原因
disturb -> v.   令人不安
equal -> v.   等于
vicar -> n.   牧师
raise -> v.   募集，筹（款）
torchlight -> n.   电筒光
goddess(tile) -> n.   女神
archaeologist -> n.   考古学家
Aegean -> adj. 爱玲海的
explore -> v.   考察，勘探
promontory -> n.   海角
prosperous -> adj. （经济上）繁荣的，昌盛的
civilization -> n.   文明
storey -> n.   楼层
drainage -> n.   排水
worship -> n.   祟拜
sacred -> adj. 宗教的，神圣的
fragment -> n.   碎片
remains -> n.   遗物，遗迹，废墟
classical -> adj. （希腊和罗马）古化的
reconstruct -> v.   修复
rest -> v.   倚放，放置
hip -> n.   屁股，臀部
full-length -> adj. （裙衣）拖地长的
graceful -> adj. 优雅的
identity -> n.   身份
manual -> adj. 体力的
collar -> n.  衣领
sacrifice -> v.  牺牲，献出
privilege -> n.  好处
dustman -> n.  清洁工
corporation -> n.  公司
overalls -> n.  工作服
shower -> n.  淋浴
secret -> n.  秘密
status -> n.  地位
editor -> n.   编辑
extreme -> n.   极端
statistics -> n.   统计数字
journalist -> n.   新闻记者
president -> n.   总统
palace -> n.   王宫；宏伟的住宅
publish -> v.   出版
fax -> n.   传真
impatient -> adj. 不耐烦的
fire -> v.   解雇
originally -> adv. 起初，原先，从前
