plead -> v.   找（借口），辩解
ignorance -> n.   无知，不懂
publication -> n.   出版物
newlyweds -> n.   新婚夫妇
gaily -> adv. 愉快地，高兴地
leisure -> n.   空闲
keen -> adj. 热心的，渴望的
advisory -> adj. 咨询的
novice -> n.   新手
consumer -> n.   消费者，顾客
assemble -> v.   装配，组装
outlet -> n.   出路
creative -> adj. 创造性的
handyman -> n.   手巧的人，能工巧匠
resourceful -> adj. 足智多谋的
fuse -> v.   由于烧断保险丝而短路
rickety -> adj. 要散架的，晃动的
clog -> v.   堵塞
delusion -> n.   错觉
lawn mower -> 割草机
adjustment -> n.   调整
screw -> n.   螺丝钉
dismantle -> v.   拆卸
chunk -> n.   （厚）块
snap -> v.   绷断
insurmountable -> adj. 不能克服的，难以对付的
jigsaw -> n.   线锯
nag -> v.   唠叨不休
rust -> v.   生锈
pollution -> n.   污染
overpopulated -> adj. 人口多的
over-industrialized -> adj. 过度工业化的
sheer -> adj. 纯粹的，不掺杂的
worldwide -> adv. 在全世界
overwhelm -> v.   制服，使不知所措
pollute -> v.   污染
pesticide -> n.   杀虫剂
fertilizer -> n.   肥料
salmonella -> n.   沙门氏菌
listeria -> n.   利斯特杆菌
vegetarian -> n.   吃素的人
organically-grown -> adj. 有机培植的（不施化肥和其他化学药品培植）
insidious -> adj. 暗中为害的
urban -> adj. 城市的
burglar -> n.   窃贼
burgle -> v.   入室偷窃
scream -> v.   尖叫
profound -> adj. 极度的
irritation -> n.   烦躁
incessantly -> adv. 连续不断地
whine -> v.   发呜呜声
helicopter -> n.   直升飞机
maximum -> adj. 最大的
technology -> n.   技术
contribution -> n.   贡献
mobile -> adj. 可移动的
snore -> v.   打鼾
offender -> v.   冒犯者
staggering -> adj. 令人惊愕的
trumpet -> v.   吹号
partner -> n.   伙伴
inaccessible -> adj. 难接近的,达不到的
hospitable -> adj. 不好客的
hostile -> adj. 不友好的,有敌意的
vicinity -> n.   周围,近邻
architectural -> adj. 建筑的
fresco -> n.   壁画
abruptly -> adv. 突然地,意外地
tramp -> v.   徒步行进
moor -> v.   （用绳、链、锚）系（船）
ferry -> v.   （用渡船）运
straggle -> v.   蔓延，散乱分布
sardine -> n.   沙丁鱼，沙丁鱼罐头
rag -> n.   破烂衣服
procession -> adj. 不动的
shawl -> n.   披巾，围巾
peer -> v.   凝视，盯着
quicken -> v.   加快
rambling -> adj. 杂乱无章的
sentimentally -> adv. 感情上，多情地
immaculate -> adj. 清洁的，无污点的
lavishly -> adv. 慷慨地，大方地
parquet -> n.   镶木地板
gleam -> v.   发亮，闪光
preside -> v.   指挥
invisible -> adj. 看不见的，无形的
scrub -> v.   擦拭，刷洗
enlightened -> adj. 开明的
fickleness -> n.   变化无常
unrelenting -> adj. 不屈不挠的，不松懈的确良
disillusion -> v.   使幻想破灭的
qualification -> n.    资格，能力
mirth -> n.   欢笑，高兴
stack -> v.   整齐地堆放
cellar -> n.   地窖
resolution -> n.   决心
mentally -> adv. 内心里
compile -> v.   编辑，编制
formidable -> adj. 令人畏惧的
recur -> v.   再发生，又出现
regularity -> n.   规律性
accomplishment -> n.   成就
attainment -> n.   达到
inveterate -> adj. 根深蒂固的
self-improvement -> n.   自我完善
scheme -> n.   简单的计划，方案
ambitious -> adj. 雄心勃勃的
pitfall -> n.   意外的困难，易犯的错误
modest -> adj. 要求不过分的
assiduously -> adv. 刻苦地
self-discipline -> n.   自我约束
frame -> n.   躯体
betray -> v.   暴露，显露
troop -> v.   成群结队地走动
unsettle -> v.   使不安
taunt -> n.   嘲笑，奚落人的话
jibe -> n.   嘲弄，挖苦
good-humouredly -> adv. 和气地，心情好地
wane -> v.   逐渐变小，变弱
hypnotize -> v.   使欲睡，使蒙胧
undoing -> n.   祸根，毁灭的原因
screen -> n.   电视机屏幕
