illusion -> n.   幻想，错觉
pastoral -> adj. 田园的
breed (bred, bred) -> v.   培育
rapture -> n.   欣喜
extol -> v.   赞美，颂扬
superior -> adj. 优越的
cockcrow -> n.   鸡叫
twitter -> v.   （鸟）吱吱叫，嘁嘁喳喳叫
glint -> v.   闪烁
pasture -> n.   牧场
idyllic -> adj. 田园诗的
virtually -> adv. 几乎，差不多
dubious -> adj. 可疑的，怀疑的
privilege -> n.   特权
misery -> n.   苦难
acquaintance -> n.   熟人
treat -> n.   难得的乐事，享受
dweller -> n.   居住者
stagger -> v.   摇晃，蹒跚
exotic -> adj. 导乎寻常的，外来的
glow -> n.   白炽光
descend -> v. 缩进，隐藏
descend -> v.   缩进，隐藏
obstinately -> adv. 固执地，顽固地
caveman -> n.   （远古）洞穴人
pot-holing -> n.   洞穴探险，洞穴探险运动
solitude -> n.   孤独，寂寞
lure -> v.   引诱，诱惑
pot-holer -> n.   洞穴探险者
undertaking -> n.   任务，工作
foresight -> n.   预见；深谋远虑
foretell -> v.   预言
Grenoble -> n.   格里诺布尔
chasm -> n.   断层，裂口，陷坑
flaw -> n.   小裂缝
distinguished -> adj. 杰出的，著名的
Everest -> n.   珠穆朗玛峰
wade -> v.   涉水
waterfall -> n.   瀑布
gear -> n.   一套用具
inflatable -> adj. 可充气的
rubble -> n.   碎瓦
insistent -> adj. 连续的，不断的
boom -> v.   轰响
waterspout -> n.   强大的水柱
cleft -> n.   裂隙，开
cavern -> n.   在洞穴
stalagmite -> n.   石笋
stalactite -> n.   钟乳石
limestone -> n.   石灰石
glisten -> v.   闪烁
cerie -> adj. 引塌恐惧的，可怕的
dome -> n.   穹窿，圆顶
admittedly -> adv. 公认地
purchase -> v.   买
annual -> adj. 一年一度的
teenager -> n.  （13至19岁的）青少年
capsize -> v.   （船）翻
shiver -> v.   打颤，发抖
dive -> v.   （头向下）跳水
haul -> v.   拖曳
hawser -> n.   粗缆绳
rim -> n.   （圆形物品的）外沿，边
winch -> n.   绞车
agonizing -> adj. 精神紧张的，提心吊胆的
perch -> v.   处于（高处）
precariously -> adv. 危险地，不稳固地
overbalance -> v.   失去平衡
clamp -> n.   夹钳，夹板
vertically -> adv. 垂直地
torrent -> n.   激流，洪流
rebound -> v.   弹回
positively -> adv. 绝对地，完全地
compartment -> n.   列车客车厢内的分隔间（或单间）
cramped -> adj. 窄小的
stuffy -> adj. 憋气的，闷气的
monotonous -> adj. 枯燥的，乏味的
rhythm -> n.   有节奏的运动
click -> v.   发出咔哒声
lull -> v.   催人欲睡
snatch -> n.   短时，片段
sleeper -> n.   卧铺
fumble -> v.   乱摸，摸索
inspection -> n.   检查
inevitably -> adv. 必然地，不可避免地
destination -> n.   目的地
exhaust -> v.   使精疲力尽
motorway -> n.   快车道
ferry -> n.   渡船
cruise -> n.   巡游船
civilize -> v.   使文明
spacious -> adj. 宽敞的
seasick -> adj. 晕船的
intimidate -> v.   恐吓，恫吓
disadvantage -> n.   短处，缺点
exhilarating -> adj. 使人高兴的，令人兴奋的
escapist -> n.   逍遥者
sip -> v.   呷，啜
champagne -> n.   香槟洒
refinement -> n.   精心的安排
breathtaking -> adj.激动人心的；不寻常的
soar -> v.   高飞，翱翔
effortlessly -> adv. 不费力地
landscape -> n.   景色
fresh -> adj. 精神饱满的
uncrumpled -> adj. 没有垮下来
democratic -> adj. 民主的
restrict -> v.   限制
abuse -> v.   滥用
contention -> n.   论点
untold -> adj. 数不尽
South Dakota -> 南达科他州（美国）
perpetual -> adj. 永久的
quintuplet -> n.   五胞胎之一
obscurity -> n.   默默无闻
radically -> adv. 彻底地，完全地
exclusive -> adj. 独占的，独家的
nursery -> n.   育婴室，保育室
commercialization -> n.   商品化
commodity -> n.   商品
