sitcom / situation comedy -> n 情景喜剧
news -> n 新闻节目；新闻
soap opera -> # 肥皂剧
mind -> v 介意；对（某事）烦恼
stand / stood -> v / pp 忍受；站立
educational -> adj 教育的；有教育意义的
plan -> v&n 打算；计划
hope -> v&n 希望
find out -> # 查明；弄清
discussion -> n 讨论；商量
happen -> v 发生；出现
expect -> v 预料；期待
joke -> n 笑话；玩笑
comedy -> n 喜剧；喜剧片
meaningless -> adj 毫无意义的；意思不明确的
action -> n 行动
action movie -> # 动作影片
cartoon -> n 动画片；卡通片
culture -> n 文化；文明
famous -> adj 著名的；出名的
appear -> v 出现
become / became -> v / pp 开始变得；变成
rich -> adj 富有的
successful -> adj 获得成功的；有成就的
might -> modal v 可能；可以
main -> adj 主要的；最重要的
reason -> n 原因；理由
common -> adj 普通的；常见的
film / movie -> n 电影
unlucky -> adj 不幸的；不吉利的
lose / lost -> v / pp 失去；丢失
girlfriend -> n 女朋友
ready -> adj 愿意的；准备好的
be ready to -> # 准备好（做某事）；愿意（做某事）
character -> n 人物；角色
simple -> adj 简单的；易做的
dress up -> # 装扮；乔装打扮
take sb.'s place -> # 代替；替换
army -> n 陆军；陆军部队
do a good job -> # 干得好
Mickey Mouse -> 米老鼠
Steamboat Willie -> 《威利号汽船》
Hollywood -> 好莱坞
the Hollywood Walk of Fame -> 好莱坞星光大道
