theater / theatre -> n 戏院；剧场
comfortable -> adj 使人舒服的；舒适的
seat -> n 座位；坐处（如椅子等）
screen -> n 银幕；屏幕
close -> adj （在空间、时间上）接近
ticket -> n 票；入场券
worst -> adj&adv （bad和badly的最高级）最差（的）；最坏（的）；最糟（的）
cheaply -> adv 便宜地；低廉地
song -> n 歌；歌曲
DJ -> n （电台、电视台、俱乐部的）音乐节目主持人
choose / chose -> v / pp 选择；挑选
carefully -> adv 细致地；小心地；谨慎地
reporter -> n 记者
so far -> # 到目前为止；迄今为止
fresh -> adj 新鲜的；清新的
comfortably ->adv 舒服地；舒适地
worse -> adj&adv （bad和badly的比较级）更差（的）；更坏（的）；更糟（的）
service -> n 接待；服务
pretty -> adv 相当；十分；很  adj 漂亮的
menu -> n 菜单
act -> v 扮演   n 表演者
meal -> n 早（或午、晚）餐；一餐所吃的食物
creative -> adj 有创造力的；创造性的
performer -> n 表演者；演员
talent -> n 天资；天赋
have ... in common -> # 有相同特征的；（想法、兴趣等方面）相同
magician -> n 魔术师
all kinds of -> # 各种类型的；各种各样的
beautifully -> adv 美好地；漂亮地
be up to -> # 是……的职责；由……决定
role -> n 作用；职能；角色
play a role -> # 发挥作用；有影响
winner -> n 获胜者；优胜者
prize -> n 奖；奖品；奖金
everybody -> pron 每人；人人；所有人
make up -> # 编造（故事、谎言等）
example -> n 实例；范例
for example -> # 例如
poor -> adj 贫穷的；清贫的
seriously -> adv 严重地；严肃地；认真地
take ... seriously -> # 认真对待……
give / gave -> v / pp 提供；给
crowded -> adj 人多的；拥挤的；挤满的
American Idol -> 美国偶像
America's Got Talent -> 美国达人秀
China's Got Talent -> 中国达人秀
